50 50
#########_____________________________________####
#########_____________________________________####
#########______________________________________###
####___________________________________________###
##_____________________________________________###
##_____________________________________________###
##______________________________________________##
##______________________________________________##
##______________________________________________##
##______________________________________________##
##______________________________________________##
##______________________________________________##
##______________________________________________##
##______________________________________________##
##______________________________________________##
##______________________________________________##
##______________________________________________##
##______________________________________________##
##______________________________________________##
##________________________________________________
##________________________________________________
##________________________________________________
##________________________________________________
##________________________________________________
##________________________________________________
##________________________________________________
##________________________________________________
##?_______________________________________________
####______________________________________________
####______________________________________________
####______________________________________________
####______________________________________________
####______________________________________________
####______________________________________________
####______________________________________________
####______________________________________________
####______________________________________________
####______________________________________________
####______________________________________________
####______________________________________________
####______________________________________________
####______________________________________________
####______________________________________________
####______________________________________________
####______________________________________________
####______________________________________________
####______________________________________________
####______________________________________________
####______________________________________________
#############____________________________#########
